#.....#.............#...#.......#.#.#.#...#.......#.#............................
#.#.###.#.###.#####.###.#.#.#.###.#.#.#.#.#.#######.#.###.#.#.#.###.###.#.#.#.###
#.#...#.#...#.#...#...#...#.#.......#.#.#.#.....#.#.#...#.#.#.#.#.#.#.#.#.#.#.#.#
#####.#.#########.#.###.#####.#######.#.###.#####.#.#.#.###.#.#.#.#.#.#######.#.#
#...........#.#.#...#.#.#.#.......#.#.#.....#.#.#.....#...#.#.#...#.#...#.....#.#
#####.#.###.#.#.###.#.#.#.#.###.###.#.#.#####.#.#####.#.#.#####.###.#.#####.###.#
#.....#.#.....#.#...#.#...#.#...#.....................#.#...#...#.#.....#.......#
#######.#.#####.#.#.#.###.###.#.#.#######.#.#.#######.#.#######.#.###.#.#####.#.#
#.#.#.#.#.#.....#.#.....#.#...#.#...#.....#.#.#.......#.#.#.....#.....#.#.....#.#
#.#.#.#.#.###.#####.###.#.#####.#.###.#.#####.#.#.#####.#.#.#.#.#.#.#####.#####.#
#.......#.#...#...#.#.....#.....#...#.#.#.....#.#...#...#...#.#.#.#.....#.#.#.#.#
#.#####.#.#.#.#.#.#####.#.#.###.#.#######.#######.#####.###.#.#.#####.###.#.#.#.#
#.#.#.#.#.#.#...#.#.....#.#.#.....#.#.#.....#.......#.#.#...#.#.#.#...#...#...#.#
#.#.#.#.#.#.###.#.#.###.#########.#.#.#.#.#.#.#.#.###.#####.#.###.#.#######.###.#
#.#.....#.#...#.#.#.#...#.#.....#.#.#.#.#.#.#.#.#.#...#...#.#...#...#.#.#.......#
#.#####.###.###.#####.###.#.###.#.#.#.#.#.#.#####.#.#.###.#####.#.#.#.#.###.#.###
#.#.....#.#...#.#.....#.....#...#.#.#...#.#.#.#.#.#.#...#.....#.#.#...#.....#...#
###.#####.#.###.#########.#.###.###.#.#.#####.#.#.###.#.###.#.#.###.#######.###.#
#.#.#.....#.#.#.#.....#.#.#...#.#.#.#.#...#.#.......#.#.#...#.#...#...#.......#.#
#.#.#.#.###.#.#.###.#.#.###.#.#.#.#.#.#####.###.#.###.###.#.#########.#.#####.#.#
#...#.#...#...#.....#.#...#.#.#.......#.......#.#.......#.#...#.....#.#...#.#.#.#
#.###.###########.#.#.#.#####.#######.#.###.#####.#.#.#.#.###.#.###########.#.###
#.#.#...#.....#.#.#.#...#.....#.#.#.......#.#.#.#.#.#.#.....#.#.#.....#.#...#...#
#.#.#.#####.#.#.###.#####.#####.#.#.#.#######.#.#######.#.###.#.#.#.###.#.#####.#
#.....#.....#.......#.#.#.#.#.#...#.#...#...#.....#.....#...#.....#.....#...#...#
###.#####.###.#####.#.#.###.#.#.#.#.#####.#.#.#.#.###.#.#########.#####.#.#######
#...#.....#.#.#...#.#.#.#.#...#.#.........#.#.#.#...#.#...#.#.#.....#.......#.#.#
#.#.#.###.#.###.#.#.#.#.#.#.###.###.#.###.#######.#########.#.#.#.#.#######.#.#.#
#.#.....#.....#.#.....#.#.....#...#.#.#.......#...#.#.........#.#.#...#.....#...#
#.#.#.#######.#.###.###.###.#.#.###.###.#.#####.#.#.#####.#.#.#.#.#####.#.#.###.#
#.#.#.#.#...#.#...#.......#.#.#...#.#...#.....#.#.........#.#.#.#.#.....#.#.....#
#.#####.#.#.#.#####.###.#####.#.###.#.#.###.###.###.#.#.#.###.###.###.#.#####.###
#.#.#.#.#.#.#...#.....#.....#.#.#...#.#.#.#.#...#.#.#.#.#...#...#...#.#.#.#.#...#
#.#.#.#.#.#.#####.#.#########.#.#.#####.#.#.#.###.#.#####.#.#.###.#.#.#.#.#.#####
#...#.....#.....#.#...#.#.....#.#...#.....#.#.#.........#.#.#...#.#.#.#...#.....#
###.#.#.#########.###.#.#.#.#.#.#.#.#.#.#####.###.###.#####.#.#.#######.#.#.#.#.#
#.....#...#.........#.....#.#.#.#.#.#.#...#...#.#...#.#...#.#.#...#.#...#...#.#.#
#.#.#.#####.###.#.#.#.#.#.#.#.#####.###.#.#####.#.#.###.###.#####.#.#.#.#####.#.#
..#.#.....#.#...#.#.#.#.#.#.#.#.....#...#.........#.......#...#...#...#.....#.#.#
