#...........#...#.......#...#...................................#.#.#.....#...................#.#.......#...#............
#.###.###.#.#.###.#.#.###.###.#.#######.#.#.#.###.###.#####.###.#.#.#####.#.#########.#.###.#.#.#.#.#####.###.###.#.###.#
#.#.#...#.#.#.....#.#.......#.#.....#.#.#.#.#...#...#.#...#...#.........#...#...#.#...#...#.#...#.#...#.....#.#...#.#...#
#.#.#.#.#.#.#.#.#.#######.#.#.#####.#.#.#####.###.#.#.#.#.#.#######.###.#.###.###.#.#.#.#.#.#.###.#####.#####.#.###.#.#.#
#.#...#.#.#...#.#.....#...#.#...#.#.#.#...#.#.#...#.#.#.#.#.....#...#.#.#.........#.#.#.#.#.#.....#...#...#.#.#.#...#.#.#
#.#.###.#.###.#.#####.#.#.#.#.###.#.#.#.###.#########.#.#.###.#####.#.###########.#####.#######.#.#.###.#.#.#.#######.###
#.#.#...#.#...#.#...#.#.#.#...#.......#.....#...#.......#.#...#.#.....#.#.#.#.#.......#.......#.#.......#.#.........#...#
#.#.#.#######.#.#.###.#.###.#####.#####.#####.###.#.#.#.###.#.#.#.#####.#.#.#.###.###.#.#.#.#####.###.###.#.#####.#####.#
#.#.#.......#.#.....#.#...#.#...#...#...#...#.....#.#.#...#.#.#.#.....#.#.......#.#.#.#.#.#.#.#.....#...#...#...#.#.....#
#####.#####.#####.#####.#.#.###.#.#.#.#.#.#.#.#####.#.###.#.###.#.#####.###.###.#.#.###.###.#.###########.###.#.#.#.#.#.#
#.......#.......#.#.#...#.#...#...#.#.#...#.#.#...#.#...#.#.#...#...#...#...#...#.#.#...#.#.#...#.#.#...#.....#.#.#.#.#.#
#.#.###.#.###.#.###.#######.#.###.###.###.#.###.###.#.#.#####.#.#.###.###.#######.#.#####.#.#.###.#.#.###.###.#.###.#.#.#
#.#...#.#.#.#.#.#.#.......#.#...#...#...#.#...#.#.#.#.#...#...#.#.#.#.#.#.#...#.#.#...#.#.#.#...#.....#.#.#.#.#.#.#.#.#.#
###.#####.#.#.###.#####.#.#####.###.#.###.#####.#.#######.###.###.#.#.#.#.###.#.#.#.###.#.###.#.#.#####.###.#.#.#.#######
#...#.#...#.........#...#...#.....#.#.#.#.....#.........#.#.........#...........#...#.......#.#.#...#.....#.#.#.#.....#.#
#####.#.#######.#.#.###.#############.#.#######.#.#.#.#####.###.#.###.#######.###.###.#########.#.#####.###.#.#####.###.#
#.............#.#.#.#.......#.....#...........#.#.#.#.....#.#...#...........#.....#.#.#.....#.......#...#.#.....#.#...#.#
#.#####.#######.#.#.#.#######.#######.#.#####.#.#.#.#.###.#.#.###########.#.#.###.#.#.#.#.###.#.###.#.###.#.#####.###.#.#
#.#.#.#...#.....#.#...#.......#.#.#.#.#.....#...#.#.#...#.#.#...#.#...#...#.#.#...#...#.#...#.#.#.#...#.#...............#
#.#.#.###.###.#.#.###.#.#####.#.#.#.#.#.#.#####.###.#.#######.#.#.#.#.###.#########.###.###.#####.#.#.#.###########.#.###
#.#...#...#.#.#.#.#.#...#.....#.#.....#.#.#.....#...#.#.......#.#...#.#.....#.....#.#.#.#.#...#...#.#...#.......#...#.#.#
#.#.#.###.#.#.###.#.#.###.#.###.###.###############################.#.#.###.#.#####.#.#.#.###.###.#.#####.#####.#.###.#.#
#...#...#.#...#.#...#...#.#.#.....#.#.#.#...........#.#.#...#.......#.....#.......#.#.#...#...#.....#.#.#.#.#.#...#.#...#
#.#.#.#.###.#.#.#.#####.###.#.#####.#.#.#.#.#.#.#####.#.###.#.#######.#########.###.#.###.#####.#.#.#.#.#.#.#.#.#.#.#.#.#
#.#.#.#...#.#...#.#.#.#.#.#.#.#.#...#.#...#.#.#.......#...#.......#.#...#.......#.....#...#.#.#.#.#.......#...#.#...#.#.#
#.#.###.#.#########.#.###.#.#.#.#.###.#.#############.#.#.#.#.#.###.#.#.###.###.#.###.#.###.#.#.###.#.###.#.#######.###.#
#.#.#...#.#.#...#.#.#.#.#.#.#...#.#.....#.............#.#.#.#.#.#.#.#.#.#...#...#...#.#...#.#.#...#.#.#.#.....#.#.#.#.#.#
#.###.#.#.#.###.#.#.#.#.#.#####.#.#.#.#####.#####.###.#.#.#####.#.#.#.#####.#####.#####.###.#.#######.#.#.#####.#.###.#.#
#...#.#.#.#.#.....#.......#.#.#.....#.#.#.....#...#.#.#.#.#...#...#.....#.#.#.#...#.#.#.....#.#...#.#...#.....#.....#.#.#
#########.#.###.###.#####.#.#.#####.###.#.#.###.#.#.#####.#.###########.#.###.#.#.#.#.#####.#.###.#.#.#.#.#.#.#####.#.#.#
#.......#.#...#...#...#.#...#.....#.#.#...#...#.#.#...#...#.#...#...#.#...#.....#.......#...#.#.#.#...#.#.#.#...#.......#
###.###.#.#.###.#.#####.#.#.#####.###.#.###.#.#.###.#.###.#.#.###.#.#.#.###.###.#.#####.###.#.#.#.#.#.#.###.#.#####.#.#.#
#.....#.#...#...#.#.......#.....#.........#.#.#.#...#.#...#.#.#.#.#.#.#...#...#.#.#...#...#.#.....#.#.#.#.#.#.#...#.#.#.#
#.###.#.#.#.#.#########.###.#.###############.###.#.#.#.#.#.#.#.###.#.#.#####.#.#.#.#.#.#.#.#.###########.#.#.#.#.#.#.#.#
#.#...#.#.#...#...#.....#.#.#.#...#.#.............#.#.#.#.....#.....#.....#.#.#.#.#.#...#.#...#.....#.....#.#.#.#...#.#.#
#.#####.###.###.###.#####.#####.###.#.#######.#.#####.#.#.#####.#####.#.###.#.#########.###.###.#.#.#.#.#####.#.###.#.#.#
#.....#...#.#...#.#.#...#...#...#...#.#.....#.#.....#.#.#.......#...#.#...........#.........#.#.#.#...#...#...#.#...#.#.#
#.#####.###.#.###.#.#.#####.#.#.#.###.###.#.#.#####.###.#.#####.###.#.###.###.#####.#.#.#####.###.###.###.###.#####.###.#
#.#.........#.#...#.....#.#.#.#...#.#.#...#.#...#...#.#.#.#.#.#.........#...#.#.#.#.#.#.#...........#.#.#.#...#.#.#...#.#
#.###.#.#.###.###.#.#####.#.###.###.#.#.#######.#.#.#.#.#.#.#.#.#########.#####.#.#.###.#.#.###.#.###.#.###.#.#.#.#.###.#
#...#.#.#.......#.#.........#...........#.....#.#.#.#...#.#...#.#.#.#.#.#.#...#.....#.....#.#.#.#.#.#.#.....#.#...#.#.#.#
###.###.#.###.#.#.#.#.#######.###.#.#.#.#.#.#.#.#.###.#.#.###.#.#.#.#.#.#.###.#.###.###.#.#.#.#.#.#.###.#.#.#####.#.#.###
#.....#.#.#...#.....#.......#.#.#.#.#.#.#.#.#.#.#...#.#.#.#.#...#.#.#...#.#.......#...#.#.#...#.#...#.#.#.#.....#.....#.#
#####.#.#.#####.###.###.#######.#.###.###.###.#.###.###.#.#.#.#.#.#.#.###########.#####.#####.#####.#.#########.#.#.###.#
#.....#.#.....#...#...#.#...#.......#.#...#.......#.#.#.#...#.#.#...#.....#.....#.#.#.#.#.........#.......#.#.#.#.#...#.#
###.#.#.#.#.###.#.#.#####.###.###.#####.#########.#.#.#####.###.#.###.###.#.#######.#.#.#########.#.#.###.#.#.#.#####.#.#
#...#.#.#.#.#.#.#.#.#.........#...#.#.#.....#.....#.#...#.#.#.....#...#...#...#...#.#...#.#.#.....#.#...#.....#.#.#.....#
#.#.#########.#######.#.#.#.#.#.#.#.#.#######.#.###.#.###.###.###.#.#.#######.#.###.###.#.#.#########.#######.#.#.#.###.#
#.#.......#.....#.#...#.#.#.#.#.#.#.......#...#.#.#.#...#...#...#...#.....#...#.#.#.#...#...#.........#.#.#...#...#...#.#
#####.#.###.#.###.###.#.#####.#.###.#####.###.#.#.#.#.###.#.#########.#######.#.#.#.#.###.###.#.#.###.#.#.###.#######.###
#...#.#...#.#.........#.#.#...#.......#.#...#.#.#.....#.#.#...#.#.#.#.#.#.#.#.#.#...#.....#.#.#.#.#.#.#.....#...#.#.#...#
#.#.#########.###.#####.#.###.#.#######.#.#.###.#.#.###.###.###.#.#.###.#.#.#.#.###.#.#.###.#####.#.#.#.###.#.#.#.#.#.###
#.#.........#.#...#...#.#.#.#.#...#.#...#.#...#.#.#...#...#.............#.....#.#.#.#.#.......#.....#.#...#...#...#.....#
###.#####.#.###.#####.#.#.#.#.#.###.###.#.###########.#.###.###########.###.#.#.#.#.###.#.###.###.#.###########.###.#.###
#.#.....#.#.#.#...#...#.#.#.#.#.#.......#.#.#.#.#.#...#.#.#.#...........#.#.#...#.#...#.#.#...#...#...#.#...#.#...#.#.#.#
#.#.#.#.#.###.###.#.###.#.#.#######.#######.#.#.#.###.#.#.###.#####.#.###.#.#.#.#.#.###.#.#.#.#######.#.#.#.#.###.###.#.#
#.#.#.#.#.......#.#.......#.#.#.......#...#...#.#.#.#.....#.#.....#.#...#...#.#...#.#...#.#.#.#.#...#.#...#.....#.#...#.#
#.###.#.#######.#.#.#.###.#.#.###.###.#.#####.#.#.#.#.###.#.#.###.#.###.#######.###.#####.###.#.#.#####.#.###.#.#.#.###.#
#...#.#...#.#.#.#.#.#.#...#.....#.#.#.#.#.#.#...........#.#.#.#...#.#...#...#...#.......#...#...#.......#.#...#.#.#.....#
#.#.###.###.#.#######.###.#.#.###.#.#.#.#.#.#.###.#######.#.#.#########.#.###.#.###.#.#.#####.#.###.#.#.#############.###
#.#.......#.........#.#.....#...#...#...#.#.#...#.#.#.#.#.#...#.#.........#...#.#.#.#.#...#...#...#.#.#...#.....#.....#.#
#.#.###.#.#.#.#.#.#######.#########.###.#.#.#.###.#.#.#.#.#.###.#.#.#.#.#.#.###.#.#.#####.#.###.#.###.#####.#.#.#.###.#.#
#.#.#...#.#.#.#.#...#.#...#.#.....#.#.....#.#.#...#.....#...#.#.#.#.#.#.#.#.#.#.#.#.#.#...#.#.#.#...#.#.....#.#.#.#.#.#.#
###.###.#.#.#####.#.#.#.###.#.###.#.###.###.#.#####.###.#.#.#.#.#.#.#####.#.#.#.#.#.#.#.###.#.#.###.#.#.#.###.###.#.#.#.#
#...#...#...#.#.#.#.#.......#.#.......#.....#...#.#...#.#.#.#...#.#.....#.#.#.........#.#.#...#...#.#...#...#.#.#...#...#
#.###.###.#.#.#.#.#.#.#.###.#.#.#.#.###.###.#.###.#####.#.###.#.#####.###.#.#.#####.#.#.#.###.#######.#.#####.#.###.###.#
#...#.#.#.#...#.#.#.#.#.#.#.#.#.#.#...#.#.#.#...#.#.....#...#.#.....#...#.#.#.#.#...#.#...........#...#.#.........#.#...#
#.#####.###.###.#####.###.#.#.###.#.#.###.#.#####.###.#.###.#.#####.#########.#.###.#####.#.###.###.###########.###.###.#
#.....#.#...#.....#...#...#.#.#...#.#.#.....#.#.#...#.#.#.#.#.#...#...#.....#...#.#.#.#...#...#.#...#...#.#.#.#.#...#.#.#
#.###.#.#.###.###.#.#.###.#####.#.#.#.#####.#.#.#.###.#.#.#.#.#.#.###.#.#####.###.#.#.#.#.###.###.#.#.###.#.#.###.###.#.#
#...#.#.#.#.#.#.#.#.#.#...#.#.#.#.#.#...#.......#.#.#.#...#.....#.#.....#.#...#.#.#...#.#.#.#...#.#.........#...#...#.#.#
#.#####.#.#.#.#.#######.#.#.#.#####.#.#.#.#######.#.###.###.###.#.#.###.#.#####.#.#######.#.###.###.#.###.###.#.#.#.#.###
#.....#.....#...#.#.....#.#.#.....#.#.#.#.#.....#.#...#...#.#...#.#...#.......#.#.#...#...#.#.#.#...#.#.#.#.#.#.#.#.#...#
###.#.#.###.#.#.#.###.###.#.#.###.#######.#.#.###.#.###.#.#.#####.###.#####.#.#.#.###.#.#.#.#.###.#.#.#.#.#.#.#.###.#.###
#...#.#...#...#.#...#...#.....#.....#...#...#.#...#.....#.#.#.#...#...#.....#.#...#.....#.......#.#.#.#.......#.#.......#
#.#.#######.#.#####.#.#.#.###.#.###.#.#####.###.#.#.#.#.#.#.#.#.###.###.#.#.#.#.#.#.#.#.#.#.###.#.#####.#.###.#.###.###.#
#.#.#.....#.#...#.....#.#...#.#.#.#.#.#.#.#.#...#...#.#.#...#.#.#.#...#.#.#.#.#.#.#.#.#.#.#.#.....#.....#.#.#.#.#.#...#.#
#.#.#####.#.###.#.###.#.###.###.#.#.#.#.#.#.#.#.#.###.#####.#.#.#.###.###.###.###.#.###.#.#####.#####.###.#.#.#.#.###.###
..#.......#.#.......#.#...#.#.....#...........#.#.#.......#.#.....#.....#...#.#.....#...#.....#.....#.#...#...#.#.......#
