.....#...
.###.#.#.
...#.#.#.
##.#.#.#.
...#.#.#.
.###.#.#.
...#...#.
#.#####..
........#
